5 5 4 4 0 0 0 0 0 0 0 0 0 0 0 0
2 5 5 4 0 0 0 0 0 0 0 0 0 0 0 0
2 2 5 4 4 0 0 0 0 0 0 0 0 0 0 0
2 2 5 5 4 4 0 0 0 0 0 0 0 0 5 5
2 2 2 5 5 4 0 0 0 0 0 0 0 5 5 3
2 2 2 2 5 4 0 0 0 0 0 0 5 5 3 3
2 2 2 2 5 5 5 5 5 5 5 5 5 3 3 3
2 2 2 2 5 4 4 4 4 4 4 4 3 3 3 3
2 2 2 5 5 4 4 0 0 0 0 0 3 3 3 3
2 2 5 5 4 4 0 0 0 0 0 0 3 3 3 3
2 2 5 4 4 0 0 0 0 0 0 0 3 3 3 3
2 2 5 4 0 0 0 0 0 0 0 0 3 3 3 3