13 13 13 13 13 13 13 13 13 13 13 13 13 13 13 13 13 13 13 13 13 13 13 13 13 13 13 13 13 13 13 13 13 13 13 13 13 13 13 13 13 13 13 13 13 13 13 13 13 13
13 13 13 13 13 13 13 13 13 13 13 13 13 13 13 13 13 13 13 13 13 13 13 13 13 13 13 13 13 13 13 13 13 13 13 13 13 13 13 13 13 13 13 13 13 13 13 13 13 13
13 13 13 13 13 13 13 13 13 13 13 13 13 13 13 13 13 13 13 13 13 13 13 13 13 13 13 13 13 13 13 13 13 13 13 13 13 13 13 13 13 13 13 13 13 13 13 13 13 13
13 13 13 13 13 13 13 13 13 13 13 13 13 13 13 13 13 13 13 13 13 13 13 13 13 13 13 13 13 13 13 13 13 13 13 13 13 13 13 13 13 13 13 13 13 13 13 13 13 13
13 13 13 13 13 13 13 13 13 13 13 13 13 13 13 13 13 13 13 13 13 13 13 13 13 13 13 13 13 13 13 13 13 13 13 13 13 13 13 13 13 13 13 13 13 13 13 13 13 13
13 13 13 13 13 13 13 13 13 13 13 13 13 13 13 13 13 13 13 13 13 13 13 13 13 13 13 13 13 13 13 13 13 13 13 13 13 13 13 13 13 13 13 13 13 13 13 13 13 13
13 13 13 13 13 13 13 18 17 17 17 17 17 17 17 17 17 17 17 17 17 17 17 17 17 17 17 17 17 17 17 17 17 17 17 17 17 17 17 17 17 17 19 13 13 13 13 13 13 13
13 13 13 13 13 13 13 15 10 10 10 43 44 45 43 44 45 43 44 45 33 34 33 34 43 44 45 43 44 45 43 44 45 11 10 10 10 10 10 10 11 11 16 13 13 13 13 13 13 13
13 13 13 13 13 13 13 15 10 11 10 46 47 48 46 47 48 46 47 48 35 36 35 36 46 47 48 46 47 48 46 47 48 10 10 10 10 10 10 10 10 10 16 13 13 13 13 13 13 13
13 13 13 13 13 13 13 15 10 10 10 49 50 51 49 50 51 49 50 51 11 11 11 11 49 50 51 49 50 51 49 50 51 10 10 10 11 10 10 10 10 11 16 13 13 13 13 13 13 13
13 13 13 13 13 13 13 15 10 10 10 43 44 45 43 44 45 43 44 45 11 25 26 11 43 44 45 43 44 45 43 44 45 10 11 11 10 10 10 10 10 10 16 13 13 13 13 13 13 13
13 13 13 13 13 13 13 15 11 10 10 46 47 48 46 47 48 46 47 48 11 27 28 11 46 47 48 46 47 48 46 47 48 10 11 11 11 10 11 10 10 10 16 13 13 13 13 13 13 13
13 13 13 13 13 13 13 15 10 10 10 49 50 51 49 50 51 49 50 51 11 11 11 11 49 50 51 49 50 51 49 50 51 11 10 10 10 10 10 10 10 10 16 13 13 13 13 13 13 13
13 13 13 13 13 13 13 15 10 10 11 43 44 45 43 44 45 43 44 45 11 11 11 11 43 44 45 43 44 45 43 44 45 10 10 11 10 10 10 10 10 10 16 13 13 13 13 13 13 13
13 13 13 13 13 13 13 15 10 11 11 46 47 48 46 47 48 46 47 48 11 11 11 11 46 47 48 46 47 48 46 47 48 10 10 10 11 10 10 10 10 10 16 13 13 13 13 13 13 13
13 13 13 13 13 13 13 15 10 10 10 49 50 51 49 50 51 49 50 51 11 11 11 11 49 50 51 49 50 51 49 50 51 10 10 10 10 11 10 10 10 11 16 13 13 13 13 13 13 13
13 13 13 13 13 13 13 15 10 11 10 11 10 10 11 10 11 11 10 10 10 11 10 10 11 10 10 10 10 10 11 10 10 10 10 10 11 10 10 11 10 10 16 13 13 13 13 13 13 13
13 13 13 13 13 13 13 15 10 10 10 10 10 10 10 11 10 10 11 11 10 10 10 11 11 10 10 10 11 10 10 10 10 10 10 10 10 10 10 10 10 10 16 13 13 13 13 13 13 13
13 13 13 13 13 13 13 15 10 10 11 10 10 10 10 10 10 10 10 11 11 11 10 11 10 11 10 11 10 10 10 10 10 10 10 10 10 11 10 10 10 10 16 13 13 13 13 13 13 13
13 13 13 13 13 13 13 15 10 10 10 10 10 10 10 10 10 10 10 10 10 10 11 10 10 10 10 10 10 11 10 11 10 10 11 10 10 10 10 10 11 10 16 13 13 13 13 13 13 13
13 13 13 13 13 13 13 15 10 10 10 10 10 10 10 11 10 10 11 10 11 10 10 10 11 10 10 10 10 10 10 10 10 10 10 10 10 10 10 11 10 10 16 13 13 13 13 13 13 13
13 13 13 13 13 13 13 15 10 11 10 10 10 10 10 10 10 10 10 11 10 10 10 10 11 10 10 10 10 10 10 10 11 10 10 10 10 10 10 11 11 11 16 13 13 13 13 13 13 13
13 13 13 13 13 13 13 15 10 10 10 11 10 10 10 10 10 10 10 11 10 10 10 10 11 10 10 10 10 10 10 10 10 10 10 10 10 10 10 11 11 11 16 13 13 13 13 13 13 13
13 13 13 13 13 13 13 15 10 10 11 10 11 10 11 11 10 11 10 10 10 10 10 10 11 10 10 10 10 10 10 10 10 10 10 10 10 11 10 11 11 11 16 13 13 13 13 13 13 13
13 13 13 13 13 13 13 15 10 10 11 10 11 11 11 11 10 10 10 10 11 11 11 11 11 11 11 11 11 10 10 10 10 10 10 10 10 10 10 10 10 10 16 13 13 13 13 13 13 13
13 13 13 13 13 13 13 15 10 11 11 10 10 11 10 11 10 11 10 10 10 10 10 10 11 10 10 10 10 10 10 11 10 10 10 11 10 10 10 10 11 10 16 13 13 13 13 13 13 13
13 13 13 13 13 13 13 15 10 10 10 10 10 10 10 10 10 10 10 10 10 10 10 10 11 10 10 10 10 10 10 10 10 10 10 10 10 10 10 10 10 10 16 13 13 13 13 13 13 13
13 13 13 13 13 13 13 15 10 10 11 10 10 10 22 10 10 10 10 10 10 10 10 10 11 10 10 10 11 10 10 10 10 11 10 10 10 10 11 10 10 10 16 13 13 13 13 13 13 13
13 13 13 13 13 13 13 15 10 10 10 10 10 11 11 10 10 10 11 10 10 10 10 10 11 10 10 10 10 10 10 10 10 10 10 10 10 10 10 10 10 10 16 13 13 13 13 13 13 13
13 13 13 13 13 13 13 15 10 11 10 10 10 10 10 10 11 10 10 10 10 11 10 10 10 10 10 10 10 11 11 10 10 10 10 11 10 11 10 10 10 10 16 13 13 13 13 13 13 13
13 13 13 13 13 13 13 15 10 10 10 10 22 10 10 10 10 10 10 10 10 10 10 10 10 10 10 10 10 10 10 10 10 10 10 10 10 10 10 10 11 10 16 13 13 13 13 13 13 13
13 13 13 13 13 13 13 15 10 10 10 10 10 10 22 10 10 10 10 10 10 11 10 10 10 10 10 10 10 10 10 10 10 10 10 10 10 10 10 10 10 10 16 13 13 13 13 13 13 13
13 13 13 13 13 13 13 15 10 10 11 10 11 10 10 11 10 10 11 10 10 10 10 11 10 10 10 11 10 10 10 10 10 10 10 10 10 11 10 10 10 10 16 13 13 13 13 13 13 13
13 13 13 13 13 13 13 15 10 10 10 10 10 10 10 10 10 10 10 10 10 10 10 10 10 10 10 10 10 10 11 10 10 10 10 10 10 10 10 10 10 10 16 13 13 13 13 13 13 13
13 13 13 13 13 13 13 15 10 11 10 11 10 11 10 10 10 10 10 11 10 10 10 10 10 10 11 10 10 10 10 10 10 11 10 10 10 10 10 10 11 10 16 13 13 13 13 13 13 13
13 13 13 13 13 13 13 15 10 10 10 10 10 10 10 10 11 10 10 10 10 10 10 10 10 10 10 10 10 10 10 10 10 10 10 10 11 10 10 10 10 10 16 13 13 13 13 13 13 13
13 13 13 13 13 13 13 15 10 10 11 10 10 10 10 10 10 10 10 10 11 10 10 11 10 11 10 10 10 10 10 10 11 10 10 10 10 10 10 10 10 10 16 13 13 13 13 13 13 13
13 13 13 13 13 13 13 15 10 10 10 11 10 10 11 11 10 11 11 10 10 10 10 11 11 10 10 11 10 11 10 11 10 10 10 10 10 10 11 10 10 10 16 13 13 13 13 13 13 13
13 13 13 13 13 13 13 15 11 10 10 10 10 11 11 11 10 11 11 10 10 10 10 11 11 11 10 10 10 10 10 10 10 10 10 10 11 10 10 10 10 10 16 13 13 13 13 13 13 13
13 13 13 13 13 13 13 15 10 11 10 10 10 10 10 10 10 11 11 11 11 10 10 10 10 10 10 10 10 11 10 10 10 10 10 10 11 10 10 10 10 11 16 13 13 13 13 13 13 13
13 13 13 13 13 13 13 15 11 10 10 11 10 11 10 10 10 11 11 11 11 10 10 10 10 10 10 10 10 10 10 10 10 10 10 10 10 10 10 10 10 10 16 13 13 13 13 13 13 13
13 13 13 13 13 13 13 15 10 10 10 10 10 10 10 10 10 10 10 10 10 10 10 10 10 10 10 10 10 10 10 10 10 10 10 10 10 10 10 10 10 10 16 13 13 13 13 13 13 13
13 13 13 13 13 13 13 15 10 10 10 10 10 10 10 10 10 10 11 10 10 10 10 10 10 10 10 10 11 10 10 10 10 11 10 10 10 10 10 10 10 10 16 13 13 13 13 13 13 13
13 13 13 13 13 13 13 20 14 14 14 14 14 14 14 14 14 14 14 14 14 14 14 14 14 14 14 14 14 14 14 14 14 14 14 14 14 14 14 14 14 14 21 13 13 13 13 13 13 13
13 13 13 13 13 13 13 13 13 13 13 13 13 13 13 13 13 13 13 13 13 13 13 13 13 13 13 13 13 13 13 13 13 13 13 13 13 13 13 13 13 13 13 13 13 13 13 13 13 13
13 13 13 13 13 13 13 13 13 13 13 13 13 13 13 13 13 13 13 13 13 13 13 13 13 13 13 13 13 13 13 13 13 13 13 13 13 13 13 13 13 13 13 13 13 13 13 13 13 13
13 13 13 13 13 13 13 13 13 13 13 13 13 13 13 13 13 13 13 13 13 13 13 13 13 13 13 13 13 13 13 13 13 13 13 13 13 13 13 13 13 13 13 13 13 13 13 13 13 13
13 13 13 13 13 13 13 13 13 13 13 13 13 13 13 13 13 13 13 13 13 13 13 13 13 13 13 13 13 13 13 13 13 13 13 13 13 13 13 13 13 13 13 13 13 13 13 13 13 13
13 13 13 13 13 13 13 13 13 13 13 13 13 13 13 13 13 13 13 13 13 13 13 13 13 13 13 13 13 13 13 13 13 13 13 13 13 13 13 13 13 13 13 13 13 13 13 13 13 13
13 13 13 13 13 13 13 13 13 13 13 13 13 13 13 13 13 13 13 13 13 13 13 13 13 13 13 13 13 13 13 13 13 13 13 13 13 13 13 13 13 13 13 13 13 13 13 13 13 13