13 13 13 13 13 13 13 13 13 13 13 13 13 13 13 13 13 13 13 13 13 13 13 13 13 13 13 13 13 13 13 13 13 13 13 13 13 13 13 13 13 13 13 13 13 13 13 13 13 13
13 13 13 13 13 13 13 13 13 13 13 13 13 13 13 13 13 13 13 13 13 13 13 13 13 13 13 13 13 13 13 13 13 13 13 13 13 13 13 13 13 13 13 13 13 13 13 13 13 13
13 13 13 13 13 13 13 13 13 13 13 13 13 13 13 13 13 13 13 13 13 13 13 13 13 13 13 13 13 13 13 13 13 13 13 13 13 13 13 13 13 13 13 13 13 13 13 13 13 13
13 13 13 13 13 13 13 13 13 13 13 13 13 13 13 13 13 13 13 13 13 13 13 13 13 13 13 13 13 13 13 13 13 13 13 13 13 13 13 13 13 13 13 13 13 13 13 13 13 13
13 13 13 13 13 13 13 13 13 13 13 13 13 13 13 13 13 13 13 13 13 13 13 13 13 13 13 13 13 13 13 13 13 13 13 13 13 13 13 13 13 13 13 13 13 13 13 13 13 13
13 13 13 13 13 13 13 13 13 13 13 13 13 13 13 13 13 13 13 13 13 13 13 13 13 13 13 13 13 13 13 13 13 13 13 13 13 13 13 13 13 13 13 13 13 13 13 13 13 13
13 13 13 13 13 13 13 18 17 17 17 17 17 17 17 17 17 17 17 17 17 17 17 17 17 17 17 17 17 17 17 17 17 17 17 17 17 17 17 17 17 17 19 13 13 13 13 13 13 13
13 13 13 13 13 13 13 15 10 10 10 10 10 10 10 10 10 10 10 10 10 10 10 10 10 10 10 10 10 10 10 10 11 10 10 10 10 10 10 10 10 11 16 13 13 13 13 13 13 13
13 13 13 13 13 13 13 15 10 10 10 10 10 10 10 10 10 10 10 10 10 10 10 10 10 10 10 10 10 10 10 10 10 10 10 10 10 10 10 10 10 10 16 13 13 13 13 13 13 13
13 13 13 13 13 13 13 15 10 10 10 10 10 10 10 10 10 10 10 10 10 10 10 10 10 10 10 10 10 10 10 10 10 10 10 10 11 10 10 10 10 11 16 13 13 13 13 13 13 13
13 13 13 13 13 13 13 15 10 10 10 10 10 10 10 10 10 10 10 10 11 10 10 10 10 10 10 10 11 10 10 10 10 10 10 10 10 10 10 10 10 10 16 13 13 13 13 13 13 13
13 13 13 13 13 13 13 15 10 10 10 10 10 10 10 10 10 10 10 10 10 10 10 10 10 10 10 10 10 10 10 10 10 10 10 10 10 10 10 10 10 10 16 13 13 13 13 13 13 13
13 13 13 13 13 13 13 15 10 10 10 10 10 10 10 10 10 10 10 10 10 10 10 10 10 10 10 10 10 10 10 10 10 10 10 10 10 10 10 10 10 10 16 13 13 13 13 13 13 13
13 13 13 13 13 13 13 15 10 10 10 10 10 10 10 10 10 10 10 10 10 10 10 10 10 11 10 10 10 10 10 10 10 10 11 10 10 10 10 10 10 10 16 13 13 13 13 13 13 13
13 13 13 13 13 13 13 15 10 10 10 10 10 10 10 10 11 10 10 10 10 10 10 10 10 10 10 10 10 10 10 10 10 10 10 10 10 10 10 10 10 10 16 13 13 13 13 13 13 13
13 13 13 13 13 13 13 15 10 10 10 10 10 10 10 10 10 10 10 10 10 10 10 10 10 10 10 11 10 10 11 10 10 10 10 10 10 10 10 10 10 10 16 13 13 13 13 13 13 13
13 13 13 13 13 13 13 15 10 10 10 10 10 10 11 10 10 10 10 10 10 11 10 10 10 10 10 10 10 10 23 10 10 10 10 10 10 10 10 10 10 10 16 13 13 13 13 13 13 13
13 13 13 13 13 13 13 15 10 10 10 10 10 10 10 10 10 10 11 10 10 10 10 10 10 10 10 10 10 10 10 10 10 10 10 10 10 10 10 10 10 10 16 13 13 13 13 13 13 13
13 13 13 13 13 13 13 15 10 10 10 10 10 10 10 10 10 10 10 11 10 10 10 10 10 11 10 10 10 10 10 10 10 10 10 10 10 10 10 10 10 10 16 13 13 13 13 13 13 13
13 13 13 13 13 13 13 15 10 10 10 10 10 10 10 10 10 10 10 10 10 10 10 10 10 10 10 10 10 11 10 10 10 10 11 10 10 10 10 10 10 10 16 13 13 13 13 13 13 13
13 13 13 13 13 13 13 15 10 10 10 10 10 10 10 10 10 10 23 10 10 10 10 11 11 10 10 10 10 10 10 10 10 10 10 10 10 10 10 10 10 10 16 13 13 13 13 13 13 13
13 13 13 13 13 13 13 15 10 10 10 10 10 10 10 10 10 10 10 10 10 10 10 10 10 10 11 10 10 10 10 10 11 10 10 10 10 10 10 10 10 10 16 13 13 13 13 13 13 13
13 13 13 13 13 13 13 15 10 10 10 11 10 10 10 10 10 10 10 23 10 10 10 10 10 10 10 10 10 10 10 10 10 10 10 10 10 10 10 10 10 10 16 13 13 13 13 13 13 13
13 13 13 13 13 13 13 15 10 10 10 10 10 10 10 10 10 10 10 10 10 10 10 10 10 10 10 10 10 10 10 10 10 10 10 10 10 10 10 10 10 10 16 13 13 13 13 13 13 13
13 13 13 13 13 13 13 15 10 10 10 10 10 10 10 10 10 11 10 10 10 10 10 11 10 10 10 10 23 10 10 10 10 10 10 10 10 10 10 10 10 10 16 13 13 13 13 13 13 13
13 13 13 13 13 13 13 15 10 10 10 10 10 10 10 10 10 10 10 10 10 11 10 10 10 23 10 10 10 10 10 11 10 10 10 11 10 10 10 10 10 10 16 13 13 13 13 13 13 13
13 13 13 13 13 13 13 15 10 10 10 10 10 10 10 10 10 10 10 10 10 10 10 10 10 10 10 10 10 10 10 10 10 10 10 10 10 10 10 10 10 10 16 13 13 13 13 13 13 13
13 13 13 13 13 13 13 15 10 10 10 10 10 10 22 10 10 10 10 10 10 10 10 10 10 10 10 10 11 10 10 10 10 10 10 10 10 10 10 10 10 10 16 13 13 13 13 13 13 13
13 13 13 13 13 13 13 15 10 10 10 10 10 10 10 10 10 10 11 10 10 10 10 10 10 10 11 10 10 10 10 10 10 10 10 10 10 10 10 10 10 10 16 13 13 13 13 13 13 13
13 13 13 13 13 13 13 15 10 10 10 10 10 10 10 10 11 10 10 10 10 11 10 10 10 10 10 10 10 11 11 10 10 10 10 10 10 10 10 10 10 10 16 13 13 13 13 13 13 13
13 13 13 13 13 13 13 15 10 10 10 10 22 10 10 10 10 10 10 10 10 10 10 10 10 10 10 10 10 10 10 10 10 10 10 10 10 10 10 10 10 10 16 13 13 13 13 13 13 13
13 13 13 13 13 13 13 15 10 10 10 10 10 10 22 10 10 10 10 10 10 11 10 10 10 10 10 10 10 10 10 10 10 10 10 10 10 10 10 10 10 10 16 13 13 13 13 13 13 13
13 13 13 13 13 13 13 15 10 10 10 10 10 10 10 11 10 10 11 10 10 10 10 10 10 10 10 11 10 10 10 10 10 10 10 10 10 11 10 10 10 10 16 13 13 13 13 13 13 13
13 13 13 13 13 13 13 15 10 10 10 10 10 10 10 10 10 10 10 10 10 10 10 10 10 10 10 10 10 10 11 10 10 10 10 10 10 10 10 10 10 10 16 13 13 13 13 13 13 13
13 13 13 13 13 13 13 15 10 10 10 10 10 10 10 10 10 10 10 10 10 10 10 10 10 10 11 10 10 10 10 10 10 10 10 10 10 10 10 10 10 10 16 13 13 13 13 13 13 13
13 13 13 13 13 13 13 15 10 10 10 10 10 10 10 10 11 10 10 10 10 10 10 10 10 10 10 10 10 10 10 10 10 10 10 10 10 10 10 10 10 10 16 13 13 13 13 13 13 13
13 13 13 13 13 13 13 15 10 10 11 10 10 10 10 10 10 10 10 10 10 10 10 11 10 10 10 10 10 10 10 10 10 10 10 10 10 10 10 10 10 10 16 13 13 13 13 13 13 13
13 13 13 13 13 13 13 15 10 10 10 10 10 10 10 10 10 10 10 10 10 10 10 10 10 10 10 10 10 10 10 10 10 10 10 10 10 10 10 10 10 10 16 13 13 13 13 13 13 13
13 13 13 13 13 13 13 15 10 10 10 10 10 10 10 10 10 11 10 10 10 10 10 10 10 10 10 10 10 10 10 10 10 10 10 10 10 10 10 10 10 10 16 13 13 13 13 13 13 13
13 13 13 13 13 13 13 15 10 10 10 10 10 10 10 10 10 10 10 10 10 10 10 10 10 10 10 10 10 10 10 10 10 10 10 10 11 10 10 10 10 10 16 13 13 13 13 13 13 13
13 13 13 13 13 13 13 15 10 10 10 11 10 10 10 10 10 10 10 10 10 10 10 10 10 10 10 10 10 10 10 10 10 10 10 10 10 10 10 10 10 10 16 13 13 13 13 13 13 13
13 13 13 13 13 13 13 15 10 10 10 10 10 10 10 10 10 10 10 10 10 10 10 10 10 10 10 10 10 10 10 10 10 10 10 10 10 10 10 10 10 10 16 13 13 13 13 13 13 13
13 13 13 13 13 13 13 15 10 10 10 10 10 10 10 10 10 10 11 10 10 10 10 10 10 10 10 10 11 10 10 10 10 11 10 10 10 10 10 10 10 10 16 13 13 13 13 13 13 13
13 13 13 13 13 13 13 20 14 14 14 14 14 14 14 14 14 14 14 14 14 14 14 14 14 14 14 14 14 14 14 14 14 14 14 14 14 14 14 14 14 14 21 13 13 13 13 13 13 13
13 13 13 13 13 13 13 13 13 13 13 13 13 13 13 13 13 13 13 13 13 13 13 13 13 13 13 13 13 13 13 13 13 13 13 13 13 13 13 13 13 13 13 13 13 13 13 13 13 13
13 13 13 13 13 13 13 13 13 13 13 13 13 13 13 13 13 13 13 13 13 13 13 13 13 13 13 13 13 13 13 13 13 13 13 13 13 13 13 13 13 13 13 13 13 13 13 13 13 13
13 13 13 13 13 13 13 13 13 13 13 13 13 13 13 13 13 13 13 13 13 13 13 13 13 13 13 13 13 13 13 13 13 13 13 13 13 13 13 13 13 13 13 13 13 13 13 13 13 13
13 13 13 13 13 13 13 13 13 13 13 13 13 13 13 13 13 13 13 13 13 13 13 13 13 13 13 13 13 13 13 13 13 13 13 13 13 13 13 13 13 13 13 13 13 13 13 13 13 13
13 13 13 13 13 13 13 13 13 13 13 13 13 13 13 13 13 13 13 13 13 13 13 13 13 13 13 13 13 13 13 13 13 13 13 13 13 13 13 13 13 13 13 13 13 13 13 13 13 13
13 13 13 13 13 13 13 13 13 13 13 13 13 13 13 13 13 13 13 13 13 13 13 13 13 13 13 13 13 13 13 13 13 13 13 13 13 13 13 13 13 13 13 13 13 13 13 13 13 13